0101010101010101000001010101010101010101
0101010100000000000000000000000001010101
0101010100020202000000000000000001010101
0101000000000000000000000000000000000101
0101000000000000000000000000000000000101
0101000000000000000000000000000000000101
0101000000000000000000000000000000000101
0000000000000000010101010000000000000000
0000000000000000000000000000000000000000
0101010100000000000000000000000001010101
0101010100000000000000000000000001010101
0101010101010101000001010101010101010101

image image:tiles
sprite @15,10 sprite:hero (u32)0
sprite @10,4 sprite:box (u32)0
sprite @6,10 sprite:box (u32)0
