0101010101010101010101010101010101010101
0101010101010101010101010101010101010101
0101010100000000000000000000000001010101
0101010100000000000000000000000001010101
0101010100000000000000000000000001010101
0101000000000000000000000000000000000101
0101000000000000000000000000000000000101
0101000000000000000000000000000000000101
0101000000000000000000020202020000000101
0101000000000000000000000000000000000101
0101010101010101010101010101010101010101
0101010101010101010101010101010101010101

image image:tiles
sprite @3,9 sprite:hero (u32)0
sprite @8,2 sprite:killozap (u8:dir)0x02 (u8:frames)100 (u8:duty)0xff (u8:phase)0x00
sprite @8,9 sprite:killozap (u8:dir)0x40 (u8:frames)100 (u8:duty)0xff (u8:phase)0x00
