0101010101010101010101010101010101010101
0101010101010101010101010101010101010101
0000000001010101000000000000000000000000
0000000001010101000000000000000000000000
0101010101010101000000000101010101010101
0101010101010101000200000101010101010101
0101010101010101000200000101010101010101
0101010101010101000200000101010101010101
0100000001010101000200000101010101010101
0100000001010101000000000101010101010101
0100000001010101010101010101010101010101
0101010101010101010101010101010101010101

image image:tiles
sprite @2,10 sprite:hero (u32)0
