0101010101010101010101010101010101010101
0100000000000101010000000000000000000001
0100000000000101010000000000000000000001
0100000000000101010000000000000000000001
0100000000000000000000000002020202000001
0101010000000000000000000000000000000001
0101010000000000000000000000000000000001
0101010000000000000000000000000000010101
0100000000000000000000000000000000010101
0100000000000000000101010000000000000001
0100000000000000000101010000000000000001
0101010101010101010101010101010101010101

image image:tiles
sprite @3,10 sprite:hero (u32)0
sprite @18,5 sprite:killozap (u8:dir)0x10 (u8:frames)60 (u8:duty)0xff (u8:phase)0x00
sprite @9,5 sprite:killozap (u8:dir)0x08 (u8:frames)60 (u8:duty)0xff (u8:phase)0x00
