0101010101010101010101010101010101010101
0101010100010101010101010101010001010101
0101010000000000000000000000000000010101
0101000000000000000000020202020200000101
0101010000000000000000000000000000010101
0101010000000101000000000000000000010101
0101010000000101000000000000000000010101
0101010000000000000000000000000000010101
0101000000000000000000000000000000000101
0101010000000000000000000000000000010101
0101010100010101010101010101010001010101
0101010101010101010101010101010101010101

image image:tiles
sprite @13,9 sprite:hero (u32)0
