0101010101010100000000000000000000000001
0101010101010100000000000000000000000001
0101010101010100000000000000000000000001
0000000000000000000000000000000000000000
0000000000000000000000000000000000000000
0000000000000000000000000000000000000000
0000000000000000000000000000000000000000
0000000000000000000000000000000000000000
0101010101010100000000000000020202000001
0101010101010100000000000000000000000001
0101010101010100000000000000000000000001
0101010101010100000000000000000000000001

image image:tiles
sprite @3,7 sprite:hero (u32)0
message "Screen\u0020wraps\u0020around."
