0101010101010101010101010101010101010101
0101010101010101010101010100000000010101
0101010101010101010101010100000000010101
0101000000000000000101000000000000000001
0101000000000000000101000000000000000001
0101000000000000000101000000000000000001
0101000000000000000101000000020202000001
0101010101010101010101000000000000000001
0101010101010101010101000000000000000001
0101010101010101010101010100000000010101
0101010101010101010101010100000000010101
0101010101010101010101010101010101010101

image image:tiles
sprite @4,6 sprite:hero (u32)0
message "Smoosh\u0020into\u0020the\u0020wall!"
