0101010101010101010101010101010101010101
0100000000000001010000000000000000000101
0101000202020001010000000000000000000001
0101000000000001010000000000000000000001
0101000000000001010000000000000000000001
0100000000000000000000000000000000000001
0100000000000000000000000000000000000001
0100000000000000000000000000000000000001
0100000000000000000000000000000000000001
0100000000000000000000000000000000000001
0100000000000000000000000000000000000101
0101010101010101010101010101010101010101

image image:tiles
sprite @2,10 sprite:hero (u32)0
sprite @5,10 sprite:box (u32)0
