0101010101010101010100000000000000000101
0101010101010101010100000000000000000101
0000000000000000000000000000000000000000
0000000002020200000000000000000000000000
0000000000000000000000000000000000000000
0000000000000000000000000000000000000000
0000000000000000000000000000000000000000
0000000000000000000000000000000000000000
0000000000000000000000000000000000000000
0101010101010101010100000000000000000101
0101010101010101010100000000000000000101
0101010101010101010100000000000000000101

image image:tiles
sprite @5,8 sprite:hero (u32)0
