0101010000000101010101010101010101010101
0101010101010101010000000000000000000101
0101010101010101000000000000000000000001
0100000000000000000000000000000000000001
0100000000000000000000000002020200000001
0100000000000000000000000000000000000001
0100000000000000000000000000000000000001
0100000000000000000000000000000000000001
0101010101010101000000000000000000000001
0101010101010101010100000000000000000001
0101010101010101010101010101010101010101
0101010000000101010101010101010101010101

image image:tiles
sprite @4,10 sprite:hero (u32)0
sprite @18,9 sprite:killozap (u8:dir)0x10 (u8:frames)120 (u8:duty)0x80 (u8:phase)0x00
sprite @10,9 sprite:killozap (u8:dir)0x08 (u8:frames)120 (u8:duty)0x80 (u8:phase)0x00
