0101010101010101010101010101010101010101
0101000000000000000101010000000000000001
0100000000000000000001010002020202020001
0101000000000000000101000000000000000001
0101000000000000000101000000000000000001
0101000001010100000101010101010101010101
0101000001010100000101010101010101010101
0101000000000000000101000000000000000001
0101000000000000000101000000000000000001
0100000000000000000001010000000000000001
0101000000000000000101010000000000000001
0101010101010101010101010101010101010101

image image:tiles
sprite @4,10 sprite:box (u32)0
sprite @6,10 sprite:box (u32)0
sprite @5,4 sprite:hero (u32)0
