0101010101010101010101010101010101010101
0101010101010101010101010101010101010101
0101010101010101010101000000000101010101
0101010101010101010101000202000101010101
0101010101000000000000000000000101010101
0101010101000000000000000000000101010101
0101010101000000000000000000000101010101
0101010101000000000000000000000101010101
0101010101000000000000000000000101010101
0101010101000000000000000000000101010101
0101010101010101010101010101010101010101
0101010101010101010101010101010101010101

image image:tiles
sprite @13,2 sprite:box (u32)0
sprite @12,2 sprite:box (u32)0
sprite @7,9 sprite:hero (u32)0
