0101010101010101010101010101010101010101
0101010100000000000000000000000000000001
0101010100000000000000000000020202020001
0101010100000000000000000000000000000001
0100000000000000000000000000000000000001
0100000000000000000000000000000000000001
0100000000000000000000000000000000000001
0100000000000000000000000000000000000001
0100000000000000000000000000000001010101
0100000000000000000000000000000001010101
0100000000000000000000000000000001010101
0101010101010101010101010101010101010101

image image:tiles
sprite @2,10 sprite:hero (u32)0
